Jackknife	Origin	HIGH	MODERATE	LOW	MODIFIER	Total_Alleles	Intergenic_Alternate	Intergenic_Total
100	introduced	12435	423428	1172169	68503507	70111539	414848	1189368
100	native	12068	401728	1123366	65366489	66903651	396131	1189368
101	introduced	12245	418024	1151629	68009995	69591893	413106	1183704
101	native	11872	396415	1103707	64896853	66408847	394618	1183704
102	introduced	12282	415601	1147346	67881254	69456483	412549	1182336
102	native	11905	394448	1100153	64770122	66276628	393935	1182336
103	introduced	12394	420722	1163092	68000533	69596741	412667	1182960
103	native	12010	399032	1114549	64883457	66409048	394069	1182960
104	introduced	12452	423912	1173365	68610740	70220469	415450	1191060
104	native	12089	402152	1124439	65465555	67004235	396765	1191060
105	introduced	12294	417298	1155339	67945271	69530202	412014	1181184
105	native	11913	395757	1107027	64826666	66341363	393401	1181184
106	introduced	12390	421751	1165877	67893222	69493240	409140	1172304
106	native	12031	400086	1117364	64777868	66307349	390805	1172304
107	introduced	12134	417667	1154255	67967996	69552052	412422	1182324
107	native	11789	396287	1105663	64842860	66356599	393846	1182324
108	introduced	12437	424008	1173579	68625917	70235941	415511	1191264
108	native	12073	402256	1124640	65481095	67020064	396818	1191264
109	introduced	12226	415625	1144617	68107031	69679499	413371	1185060
109	native	11884	394237	1096790	64985372	66488283	394783	1185060
10	introduced	12365	420693	1164083	68109973	69707114	412852	1184784
10	native	12010	399172	1115527	64986193	66512902	394325	1184784
11	introduced	12345	419752	1160734	68022296	69615127	412186	1181832
11	native	11990	398214	1112332	64902803	66425339	393603	1181832
12	introduced	12234	419165	1162012	67908942	69502353	411275	1178424
12	native	11883	397905	1113877	64801692	66325357	392797	1178424
13	introduced	12285	419086	1158672	67927763	69517806	412073	1181340
13	native	11898	397652	1110459	64819158	66339167	393531	1181340
14	introduced	12407	421662	1166132	67891197	69491398	411000	1178436
14	native	12035	400024	1117508	64781877	66311444	392468	1178436
15	introduced	12312	419680	1161848	67846128	69439968	410949	1178112
15	native	11939	398213	1113252	64728329	66251733	392450	1178112
16	introduced	12316	420794	1163383	67921880	69518373	412090	1181436
16	native	11971	399179	1115071	64812364	66338585	393493	1181436
17	introduced	12410	422652	1168348	67920049	69523459	410133	1175892
17	native	12046	401008	1119698	64811220	66343972	391729	1175892
18	introduced	12222	416053	1156313	68025200	69609788	412529	1182360
18	native	11837	394479	1107481	64899306	66413103	393926	1182360
19	introduced	12195	409890	1154272	68390675	69967032	414453	1187856
19	native	11854	388597	1106005	65251160	66757616	395798	1187856
1	introduced	12312	419725	1160722	68000969	69593728	411161	1180368
1	native	11967	398149	1112312	64886672	66409100	392702	1180368
20	introduced	12381	420433	1165473	68057762	69656049	411925	1180524
20	native	12013	398835	1116824	64942641	66470313	393347	1180524
21	introduced	12429	422165	1168307	67910823	69513724	409253	1172472
21	native	12067	400623	1119606	64806118	66338414	390931	1172472
22	introduced	12414	421247	1164708	67873911	69472280	410361	1176132
22	native	12057	399729	1116344	64772255	66300385	391999	1176132
23	introduced	12432	421503	1167336	67900172	69501443	409953	1175592
23	native	12057	400026	1118729	64798910	66329722	391634	1175592
24	introduced	12382	420475	1163227	67918643	69514727	411806	1180512
24	native	12003	399030	1114804	64813482	66339319	393296	1180512
25	introduced	12363	420108	1162298	67881838	69476607	410615	1177236
25	native	11996	398462	1113918	64774615	66298991	392163	1177236
26	introduced	12433	420609	1164678	67913410	69511130	412012	1181496
26	native	12067	399106	1116272	64801250	66328695	393367	1181496
27	introduced	12348	421190	1163210	67933871	69530619	411476	1179708
27	native	11979	399593	1114813	64817574	66343959	393008	1179708
28	introduced	12344	421379	1164535	68245036	69843294	413551	1184880
28	native	11975	399714	1115889	65117329	66644907	394842	1184880
29	introduced	12384	418993	1160501	68169220	69761098	413658	1185360
29	native	12025	397564	1111956	65041892	66563437	394985	1185360
2	introduced	12390	421110	1164325	67888243	69486068	410072	1177644
2	native	12033	399529	1115905	64779252	66306719	391695	1177644
30	introduced	12339	419281	1161500	67947948	69541068	411883	1180620
30	native	11977	397993	1113213	64839240	66362423	393417	1180620
31	introduced	12349	420306	1165676	67884598	69482929	410396	1176612
31	native	11987	398797	1117230	64771800	66299814	391896	1176612
32	introduced	12287	421440	1167240	67923729	69524696	409568	1174224
32	native	11945	399726	1118647	64817070	66347388	391271	1174224
33	introduced	12401	421315	1165314	67860572	69459602	410828	1177944
33	native	12038	399829	1116775	64763250	66291892	392429	1177944
34	introduced	12350	419857	1161845	67819019	69413071	409910	1175472
34	native	11980	398489	1113746	64720732	66244947	391608	1175472
35	introduced	12388	422996	1168858	67961743	69565985	408911	1171680
35	native	12028	401340	1120145	64842545	66376058	390421	1171680
36	introduced	12450	423865	1172942	68338670	69947927	411870	1179912
36	native	12080	402069	1124061	65205287	66743497	393319	1179912
37	introduced	12402	419856	1161201	68036164	69629623	412789	1183236
37	native	12034	398272	1112693	64918402	66441401	394168	1183236
38	introduced	12398	421982	1166307	67896885	69497572	410968	1177824
38	native	12029	400316	1117788	64792260	66322393	392453	1177824
39	introduced	12339	420904	1166339	67902835	69502417	411349	1179108
39	native	11977	399323	1117896	64796855	66326051	392921	1179108
3	introduced	12368	421562	1166941	67902566	69503437	410819	1179900
3	native	11994	399972	1118378	64789837	66320181	392268	1179900
40	introduced	12393	421350	1166201	67912612	69512556	411731	1180632
40	native	12024	399664	1117376	64797573	66326637	393148	1180632
41	introduced	12298	419481	1160841	67860369	69452989	411550	1179612
41	native	11930	398096	1112828	64753414	66276268	393002	1179612
42	introduced	12357	421041	1164251	67875421	69473070	410458	1176540
42	native	11992	399510	1115726	64762301	66289529	392042	1176540
43	introduced	12364	420934	1164185	67948793	69546276	410831	1177728
43	native	11990	399285	1115722	64832148	66359145	392298	1177728
44	introduced	12449	423622	1172598	68600198	70208867	415405	1190844
44	native	12079	401896	1123710	65456316	66994001	396722	1190844
45	introduced	12337	419881	1163412	68031254	69626884	411895	1179708
45	native	11973	398497	1115125	64921112	66446707	393425	1179708
46	introduced	12397	419687	1163523	67859416	69455023	410207	1175676
46	native	12033	398223	1114963	64742468	66267687	391642	1175676
47	introduced	12352	420771	1165590	67913076	69511789	411892	1180392
47	native	11981	399180	1116948	64796670	66324779	393253	1180392
48	introduced	12324	419580	1160581	67894981	69487466	411741	1180332
48	native	11952	398012	1112137	64774019	66296120	393163	1180332
49	introduced	12362	420001	1162033	67869135	69463531	411308	1180092
49	native	12016	398347	1113457	64760189	66284009	392897	1180092
4	introduced	12305	418620	1160951	67904155	69496031	411052	1180044
4	native	11946	397094	1112549	64793350	66314939	392602	1180044
50	introduced	12351	421772	1165429	67886643	69486195	410363	1176936
50	native	11984	400186	1116752	64773035	66301957	392031	1176936
51	introduced	12384	419824	1159925	68059329	69651462	412414	1181784
51	native	12022	398285	1111510	64938342	66460159	393781	1181784
52	introduced	12455	424084	1173620	68629323	70239482	415523	1191276
52	native	12089	402328	1124688	65484416	67023521	396830	1191276
53	introduced	12316	420306	1163129	68049589	69645340	411431	1180272
53	native	11968	398649	1114419	64929004	66454040	392961	1180272
54	introduced	12370	421099	1163301	67874677	69471447	410895	1178112
54	native	12001	399353	1114477	64758640	66284471	392390	1178112
55	introduced	12366	421886	1167360	67935476	69537088	410649	1177116
55	native	12009	400279	1118723	64827614	66358625	392201	1177116
56	introduced	12384	420606	1165829	67893344	69492163	410026	1175412
56	native	12020	399033	1117083	64782405	66310541	391600	1175412
57	introduced	12416	420986	1165269	67894409	69493080	410546	1176720
57	native	12054	399394	1116616	64781852	66309916	392117	1176720
58	introduced	12396	421887	1167671	67951843	69553797	408840	1171932
58	native	12031	400206	1118989	64833709	66364935	390480	1171932
59	introduced	12320	419295	1164088	68322191	69917894	413861	1186968
59	native	11957	397905	1115526	65189018	66714406	395291	1186968
5	introduced	12388	421889	1167375	67906922	69508574	410595	1179396
5	native	12021	400280	1118689	64784471	66315461	392160	1179396
60	introduced	12294	417660	1152467	68112182	69694603	413171	1184148
60	native	11948	396180	1104542	64988119	66500789	394601	1184148
61	introduced	12281	415909	1156116	67891864	69476170	411393	1180032
61	native	11903	394450	1107750	64780219	66294322	392914	1180032
62	introduced	12256	418883	1155800	67814414	69401353	411432	1179756
62	native	11914	397574	1108411	64731866	66249765	393075	1179756
63	introduced	12364	420477	1163791	67918369	69515001	410532	1177164
63	native	12013	399039	1115613	64810325	66336990	392123	1177164
64	introduced	12337	420237	1160962	67904127	69497663	411261	1178520
64	native	11968	398659	1112505	64795561	66318693	392829	1178520
65	introduced	12284	419594	1160808	68043724	69636410	412862	1183260
65	native	11903	398002	1112380	64930907	66453192	394266	1183260
66	introduced	12353	422714	1170485	68475995	70081547	414882	1189104
66	native	11996	401092	1121761	65342891	66877740	396294	1189104
67	introduced	12390	420631	1164744	68054056	69651821	411289	1177560
67	native	12027	399127	1115940	64924772	66451866	392701	1177560
68	introduced	12384	420699	1163582	67922812	69519477	410679	1176888
68	native	12020	399105	1115218	64811617	66337960	392185	1176888
69	introduced	12372	421929	1167475	67914200	69515976	410279	1176348
69	native	12027	400319	1118888	64806516	66337750	391737	1176348
6	introduced	12260	417276	1158807	67882064	69470407	412797	1184676
6	native	11920	395863	1110516	64766453	66284752	394207	1184676
70	introduced	12420	421287	1165741	67878021	69477469	409345	1172508
70	native	12070	399649	1117158	64761229	66290106	390976	1172508
71	introduced	12328	421635	1165596	67907457	69507016	411492	1179876
71	native	11993	400047	1117064	64802031	66331135	392896	1179876
72	introduced	12403	422059	1167474	68303032	69904968	413831	1185732
72	native	12044	400460	1118905	65175934	66707343	395259	1185732
73	introduced	12398	421650	1164705	67995017	69593770	411261	1178664
73	native	12037	400053	1116294	64878551	66406935	392568	1178664
74	introduced	12393	422039	1165736	67925392	69525560	411078	1177692
74	native	12027	400286	1116892	64801407	66330612	392463	1177692
75	introduced	12386	420751	1164847	67902161	69500145	411521	1179396
75	native	12021	399262	1116059	64789604	66316946	392935	1179396
76	introduced	12293	419040	1158983	67841979	69432295	412289	1181904
76	native	11924	397538	1110704	64736872	66257038	393848	1181904
77	introduced	12369	420940	1162675	67926514	69522498	411216	1179228
77	native	12022	399300	1113864	64812357	66337543	392786	1179228
78	introduced	12355	421557	1168249	68492184	70094345	415027	1189704
78	native	11996	399820	1119315	65352598	66883729	396375	1189704
79	introduced	12337	421155	1165402	67987953	69586847	410971	1177884
79	native	11969	399532	1116817	64870090	66398408	392522	1177884
7	introduced	12241	419339	1161669	67865689	69458938	411127	1180488
7	native	11868	397709	1112891	64752876	66275344	392497	1180488
80	introduced	12416	420768	1164191	67891394	69488769	410718	1177572
80	native	12051	399291	1115811	64780590	66307743	392160	1177572
81	introduced	12381	420589	1165767	67900110	69498847	409760	1175088
81	native	12019	399061	1117254	64786668	66315002	391219	1175088
82	introduced	12387	422411	1167939	67927604	69530341	410277	1174788
82	native	12031	400799	1119075	64817706	66349611	391872	1174788
83	introduced	12398	422219	1169206	68272078	69875901	413483	1184580
83	native	12030	400499	1120346	65143742	66676617	394866	1184580
84	introduced	12260	417204	1157081	68038126	69624671	412459	1182132
84	native	11909	395635	1108537	64911803	66427884	393821	1182132
85	introduced	12346	419237	1164529	67903825	69499937	411656	1179996
85	native	0	0	0	0	0	0	0
86	introduced	12409	422012	1166736	67878271	69479428	411103	1178964
86	native	12037	400401	1118202	64773836	66304476	392556	1178964
87	introduced	12386	420203	1161993	67964939	69559521	411930	1180668
87	native	12020	398721	1113431	64851287	66375459	393366	1180668
88	introduced	12425	423701	1172558	68476261	70084945	414695	1188528
88	native	12061	401975	1123667	65337107	66874810	396027	1188528
89	introduced	12329	419789	1160333	68067851	69660302	412396	1182228
89	native	11965	398343	1112040	64949676	66472024	393851	1182228
8	introduced	12321	421031	1164807	67856239	69454398	410139	1178724
8	native	11962	399472	1116361	64754376	66282171	391639	1178724
90	introduced	12218	418967	1154927	67888705	69474817	412715	1183032
90	native	11866	397653	1107054	64778386	66294959	394207	1183032
91	introduced	11961	408400	1144822	67953111	69518294	413042	1183992
91	native	11591	387073	1096602	64834776	66330042	394528	1183992
92	introduced	12055	413787	1146361	68091260	69663463	413192	1183944
92	native	11725	392533	1098037	64966573	66468868	394588	1183944
93	introduced	12357	418991	1157974	67936981	69526303	412270	1181376
93	native	11987	397342	1109402	64820052	66338783	393801	1181376
94	introduced	12290	419646	1159185	67892376	69483497	411199	1179516
94	native	11927	398062	1111189	64790730	66311908	392858	1179516
95	introduced	12157	416295	1152097	67809304	69389853	411200	1179048
95	native	11805	394925	1104416	64708487	66219633	392718	1179048
96	introduced	12352	420011	1157944	68013450	69603757	412174	1181280
96	native	11975	398303	1109593	64895547	66415418	393632	1181280
97	introduced	12047	418351	1153576	67855627	69439601	412077	1181604
97	native	11670	396664	1105192	64729374	66242900	393460	1181604
98	introduced	12306	419621	1159551	67830730	69422208	409667	1175292
98	native	11947	398036	1111168	64718305	66239456	391215	1175292
99	introduced	12341	421172	1163178	67930783	69527474	411058	1177848
99	native	11967	399476	1114537	64814878	66340858	392516	1177848
9	introduced	12353	420840	1162381	67902141	69497715	410574	1179060
9	native	11999	399251	1114006	64789066	66314322	392113	1179060
